SQL=select * from expense_summary... $WHERE$ $ORDER$
DBTableName=expense_summary
DAOInterfaceName=ExpenseSummaryDAO
DAOImplementationName=PGExpenseSummaryDAO
DAOVOName=ExpenseSummary
DelegateName=ExpenseSummaryDelegate
FilterVOName=ExpenseSummaryFilter
StrutsActionName=ManageExpenseSummaryAction
SearchPageStrutsFormName=ManageExpenseSummaryForm
FormBeanVOName=ExpenseSummaryVO
SearchTableCaption=Expense Summary Search
AddRecordButtonDisplayText=Add New Expense Summary
AddSingleRecordAction=editExpenseSummary
JSPFileNameNoExtension=manageExpenseSummaries
EditJSPFileNameNoExtension=editExpenseSummary
EditTableCaption=Expense Summary
PermissionResourceConstantName=RESOURCE_ACCOUNTING_DATA_PAGE
EditPageStrutsFormName=EditExpenseSummaryForm
EditActionName=EditExpenseSummaryAction
total.fields=11
field.1=record_id,NUMERIC,filterable:true,sortable:true,wildcards:true,range:false,javatype:Long,mandatory:false
field.2=store_id,NUMERIC,filterable:false,sortable:false,wildcards:false,range:false,javatype:Integer,mandatory:false
field.3=rent,NUMERIC,filterable:true,sortable:true,wildcards:false,range:true,javatype:BigDecimal,mandatory:false
field.4=salary,NUMERIC,filterable:true,sortable:true,wildcards:false,range:true,javatype:BigDecimal,mandatory:false
field.5=bonuses,NUMERIC,filterable:true,sortable:true,wildcards:false,range:true,javatype:BigDecimal,mandatory:false
field.6=taxes_on_salary_bonuses,NUMERIC,filterable:true,sortable:true,wildcards:false,range:true,javatype:BigDecimal,mandatory:false
field.7=utilities_and_other_costs,NUMERIC,filterable:true,sortable:true,wildcards:false,range:true,javatype:BigDecimal,mandatory:false
field.8=total_cost,NUMERIC,filterable:true,sortable:true,wildcards:false,range:true,javatype:BigDecimal,mandatory:false
field.9=from_date,timestamp,filterable:false,sortable:true,wildcards:false,range:true,javatype:Date,mandatory:false
field.10=to_date,timestamp,filterable:false,sortable:true,wildcards:false,range:true,javatype:Date,mandatory:false
field.11=create_date,timestamp,filterable:false,sortable:true,wildcards:false,range:true,javatype:Date,mandatory:false

