SQL=select * from fixed_discount_rate_schedule... $WHERE$ $ORDER$
DBTableName=fixed_discount_rate_schedule
DAOInterfaceName=FixedDiscountRateScheduleDAO
DAOImplementationName=PGFixedDiscountRateScheduleDAO
DAOVOName=FixedDiscountRateSchedule
DelegateName=FixedDiscountRateScheduleDelegate
FilterVOName=FixedDiscountRateScheduleFilter
StrutsActionName=ManageFixedDiscountRateScheduleAction
SearchPageStrutsFormName=ManageFixedDiscountRateScheduleForm
FormBeanVOName=FixedDiscountRateScheduleVO
SearchTableCaption=FixedDiscountRateSchedule Search
AddRecordButtonDisplayText=Add New FixedDiscountRateSchedule
AddSingleRecordAction=editFixedDiscountRateSchedule
JSPFileNameNoExtension=manageFixedDiscountRateSchedules
EditJSPFileNameNoExtension=editFixedDiscountRateSchedule
EditTableCaption=FixedDiscountRateSchedule
PermissionResourceConstantName=RESOURCE_MANAGE_DISCOUNTS_PAGE
EditPageStrutsFormName=EditFixedDiscountRateScheduleForm
EditActionName=EditFixedDiscountRateScheduleAction
total.fields=10
field.1=schedule_id,NUMERIC,filterable:true,sortable:true,wildcards:true,range:false,javatype:Long,mandatory:false
field.2=store_id,NUMERIC,filterable:false,sortable:false,wildcards:false,range:false,javatype:Integer,mandatory:false
field.3=active,char(1),filterable:true,sortable:true,wildcards:false,range:false,javatype:String,mandatory:false
field.4=start_date,timestamp,filterable:false,sortable:true,wildcards:false,range:true,javatype:Date,mandatory:false
field.5=end_date,timestamp,filterable:false,sortable:true,wildcards:false,range:true,javatype:Date,mandatory:false
field.6=discount_rate_for_period,NUMERIC,filterable:true,sortable:true,wildcards:false,range:true,javatype:BigDecimal,mandatory:false
field.7=discount_rate_after_period,NUMERIC,filterable:true,sortable:true,wildcards:false,range:true,javatype:BigDecimal,mandatory:false
field.8=description,text,filterable:true,sortable:true,wildcards:true,range:false,javatype:String,mandatory:false
field.9=create_date,timestamp,filterable:false,sortable:true,wildcards:false,range:true,javatype:Date,mandatory:false
field.10=update_date,timestamp,filterable:false,sortable:true,wildcards:false,range:true,javatype:Date,mandatory:false

