SQL=select * from supplier_rule... $WHERE$ $ORDER$
DBTableName=supplier_rule
DAOInterfaceName=SupplierRuleDAO
DAOImplementationName=PGSupplierRuleDAO
DAOVOName=SupplierRule
DelegateName=SupplierRuleDelegate
FilterVOName=SupplierRuleFilter
StrutsActionName=ManageSupplierRuleAction
SearchPageStrutsFormName=ManageSupplierRuleForm
FormBeanVOName=SupplierRuleVO
SearchTableCaption=Supplier Rule Search
AddRecordButtonDisplayText=Add New Supplier Rule
AddSingleRecordAction=editSupplierRule
JSPFileNameNoExtension=manageSupplierRules
EditJSPFileNameNoExtension=editSupplierRule
EditTableCaption=SupplierRule
PermissionResourceConstantName=RESOURCE_MANAGE_SUPPLIER_PAGE
EditPageStrutsFormName=EditSupplierRuleForm
EditActionName=EditSupplierRuleAction
total.fields=10
field.1=supplier_id,NUMERIC,filterable:true,sortable:true,wildcards:true,range:false,javatype:Long,mandatory:false
field.2=rule_id,NUMERIC,filterable:true,sortable:true,wildcards:true,range:false,javatype:Long,mandatory:false
field.3=user_id,NUMERIC,filterable:true,sortable:true,wildcards:true,range:false,javatype:Long,mandatory:false
field.4=rule_name,text,filterable:true,sortable:true,wildcards:true,range:false,javatype:String,mandatory:false
field.5=description,text,filterable:true,sortable:true,wildcards:true,range:false,javatype:String,mandatory:false
field.6=start_date,timestamp,filterable:false,sortable:true,wildcards:false,range:true,javatype:Date,mandatory:false
field.7=end_date,timestamp,filterable:false,sortable:true,wildcards:false,range:true,javatype:Date,mandatory:false
field.8=active,char(1),filterable:true,sortable:true,wildcards:false,range:false,javatype:String,mandatory:false
field.9=create_date,timestamp,filterable:false,sortable:true,wildcards:false,range:true,javatype:Date,mandatory:false
field.10=update_date,timestamp,filterable:false,sortable:true,wildcards:false,range:true,javatype:Date,mandatory:false

