SQL=select * from web_product_schedule... $WHERE$ $ORDER$
DBTableName=web_product_schedule
DAOInterfaceName=WebProductScheduleDAO
DAOImplementationName=PGWebProductScheduleDAO
DAOVOName=WebProductSchedule
DelegateName=WebProductScheduleDelegate
FilterVOName=WebProductScheduleFilter
StrutsActionName=ManageWebProductScheduleAction
SearchPageStrutsFormName=ManageWebProductScheduleForm
FormBeanVOName=WebProductScheduleVO
SearchTableCaption=Web Product Schedule Search
AddRecordButtonDisplayText=Add New Web Product Schedule
AddSingleRecordAction=editWebProductSchedule
JSPFileNameNoExtension=manageWebProductSchedules
EditJSPFileNameNoExtension=editWebProductSchedule
EditTableCaption=WebProductSchedule
PermissionResourceConstantName=RESOURCE_MANAGE_WEB_STORE
EditPageStrutsFormName=EditWebProductScheduleForm
EditActionName=EditWebProductScheduleAction
total.fields=11
field.1=schedule_id,NUMERIC,filterable:true,sortable:true,wildcards:true,range:false,javatype:Long,mandatory:false
field.2=store_id,NUMERIC,filterable:false,sortable:false,wildcards:false,range:false,javatype:Integer,mandatory:false
field.3=active,char(1),filterable:true,sortable:true,wildcards:false,range:false,javatype:String,mandatory:false
field.4=description,text,filterable:true,sortable:true,wildcards:true,range:false,javatype:String,mandatory:false
field.5=list_id,NUMERIC,filterable:true,sortable:true,wildcards:true,range:false,javatype:Long,mandatory:false
field.6=start_date,timestamp,filterable:false,sortable:true,wildcards:false,range:true,javatype:Date,mandatory:false
field.7=end_date,timestamp,filterable:false,sortable:true,wildcards:false,range:true,javatype:Date,mandatory:false
field.8=started_on_date,timestamp,filterable:false,sortable:true,wildcards:false,range:true,javatype:Date,mandatory:false
field.9=ended_on_date,timestamp,filterable:false,sortable:true,wildcards:false,range:true,javatype:Date,mandatory:false
field.10=create_date,timestamp,filterable:false,sortable:true,wildcards:false,range:true,javatype:Date,mandatory:false
field.11=update_date,timestamp,filterable:false,sortable:true,wildcards:false,range:true,javatype:Date,mandatory:false

